6 55 4 22 32 32 1 35
0 1 2 0 0 1 2 0 0 1 3 0 0 1 2 0 4 1 2 4 0 0 0 0 1 2 5 1 6 0 0 4 1 4 1 4 1 4 1 0 4 0 6 6 0 5 1 7 8 9 9 1 9 9 9
16 17 18 19 20 17 18 19 20 17 21 19 20 17 18 19 16 17 18 22 20 20 20 20 17 23 22 17 20 20 20 16 17 22 17 22 17 22 17 20 22 20 20 20 20 22 17 24 25 26 27 28 27 29 29
20 17 23 22 20 17 18 22 20 17 18 22 20 17 18 22 20 17 18 22 20 20 34 35 36 37 38 38 39 40 20 20 17 22 17 22 17 22 17 19 22 20 34 35 38 37 36 41 42 43 43 36 27 27 44
20 17 20 22 20 17 23 22 19 17 18 22 20 17 23 22 20 17 18 22 34 35 45 46 17 20 16 17 47 48 37 38 17 22 17 22 17 22 17 16 22 34 50 46 20 20 17 33 51 44 44 17 43 52 53
20 17 20 22 19 17 20 22 16 17 23 22 20 17 20 22 16 17 23 34 50 46 19 20 17 20 20 17 20 17 19 19 17 22 17 22 17 22 17 19 34 50 46 19 20 20 17 33 51 27 27 17 44 17 58
37 36 37 37 37 36 37 37 37 36 37 37 37 36 37 37 37 36 37 45 37 37 37 37 36 37 37 36 37 36 37 37 36 37 36 37 36 37 36 37 45 37 37 37 37 37 36 64 65 66 43 36 43 36 67