6 16 4 22 32 32 1 35
73 74 75 73 72 72 73 72 73 72 1 74 75 72 1 76
17 27 77 28 72 72 28 72 17 72 17 27 77 75 17 56
28 27 27 55 72 72 28 72 17 72 17 27 27 77 17 56
55 80 80 55 81 80 55 72 55 72 55 80 80 80 55 56
28 72 72 28 83 84 17 85 17 85 17 84 85 72 17 71
86 86 86 86 86 86 86 86 86 86 86 86 86 86 79 86 