6 16 4 22 32 32 1 35
8 9 9 1 9 9 9 9 10 9 10 9 9 9 9 11
25 26 27 28 27 29 29 29 28 26 17 27 27 29 29 24
42 43 43 36 27 27 44 44 17 44 17 27 26 43 43 41
51 44 44 17 43 52 53 44 54 54 55 43 52 53 26 56
51 27 27 28 44 17 58 53 59 54 28 44 17 58 53 56
65 66 43 36 43 36 67 68 69 70 36 66 36 67 68 71