6 26 4 22 32 32 1 35
8 9 9 1 9 9 9 9 10 9 10 9 9 9 9 11 0 0 1 6 0 1 4 0 1 2
25 26 27 28 27 29 29 29 28 26 17 27 27 29 29 24 20 16 17 20 20 17 22 20 17 18
42 43 43 36 27 27 44 44 17 44 17 27 26 43 43 41 37 38 38 39 40 17 22 20 17 23
51 44 44 17 43 52 53 44 54 54 55 43 52 53 26 56 21 20 17 47 48 38 37 38 38 39
51 27 27 28 44 17 58 53 59 54 28 44 17 58 53 56 23 20 17 20 19 17 16 17 16 47
65 66 43 36 43 36 67 68 69 70 36 66 36 67 68 71 37 37 36 37 37 36 37 36 37 37