6 24 4 22 32 32 1 35
0 0 1 6 0 1 4 0 1 2 12 13 0 14 1 13 0 14 1 13 0 3 4 15
20 16 17 20 20 17 22 20 17 18 16 20 30 31 17 32 30 31 17 32 30 21 22 33
37 38 38 39 40 17 22 20 17 23 20 20 17 20 17 20 17 20 17 19 17 23 22 24
21 20 17 47 48 38 37 38 38 39 40 20 17 20 17 20 17 20 17 16 17 34 35 41
23 20 17 20 19 17 16 17 16 47 61 40 17 20 17 20 17 20 17 20 17 62 46 33
37 37 36 37 37 36 37 36 37 37 37 48 36 37 36 37 36 37 36 37 36 37 37 64