6 10 4 22 32 32 1 35
1 13 0 14 1 13 0 3 4 15
17 32 30 31 17 32 30 21 22 33
17 20 17 20 17 19 17 23 22 24
17 20 17 20 17 16 17 34 35 41
17 20 17 20 17 20 17 45 46 33
36 37 36 37 36 37 36 37 37 64